				NO 						textures/test/north.xpm	
					SO 					textures/test/south.xpm
		EA textures/test/east.xpm

				F		20			,					20			,					20
	C						67						,				200					, 			100

WE 10001
10S01
10001
10001
10001
11001
10001
10001
10001
10001
10001
11111
