NO ./textures/wall.xpm
SO ./textures/floor.xpm
WE ./textures/coin.xpm
EA ./textures/door.xpm

F 220,100,0
C 225,30,0


                    111111111111111111111111111111
                    100000000000000000000000000001        1
                    100000000000000000000000000001       1N1
                    100000000000000000000000000001        1
                    100000000000000000000000000001
                    100000000000000000000000000001
                    100000000000000000000000000001
                    110000000000000000000000000001
                     10000000000000000000000000001
                    111111111111111111111111111111


                    111111111111111111111111111111
                      10000000000000000000000000001
                       10000000000000000000000000001
                        10000000000000000000000000001
                         10000000000000100000000000001
                          1000000000001 100000000000001      1
                           10000000000010000000000000001    101
                            10000000000000000000000000001    1
                             10000000000000000000000000001
                            10000000000000000000000000001
                           10000000000000000000000000001
                          10000000000000000000000000001
                          10000000000000000000000000001
                          11111111111111111111111111111