                    111111111111111111111111111111
                    100000000000000000000000000001
                    100000000000000000000000000001
                    100000000000000000000000000001
                    100000000000000000000000000001
                    100000000000000000000000000001
                    100000000000000000000000000001
                    110000000000000000000000000001
                     10000000000000000000000000001
                      10000000000000000000000000001
                       10000000000000000000000000001
                        10000000000000000000000000001
                         10000000000000100000000000001
                          1000000000001 100000000000001      1
                           10000000000010000000000000001    1N1
                            10000000000000000000000000001    1
                             10000000000000000000000000001
                            10000000000000000000000000001
                           10000000000000000000000000001
                          10000000000000000000000000001
                          10000000000000000000000000001
                          11111111111111111111111111111