NO ./textures/wall.xpm
SO ./textures/floor.xpm
WE ./textures/coin.xpm
EA ./textures/door.xpm

F 220,100,0
C 225,30,0


111111111111111111111111111111
100000000000000000000000000001
100000000000000000110000000001
100000000000000000000011100001
100000000000000000000000100001
100000000000000000000000100001
100000000000000000000000111111
100000000001000000000000000001
110000000010100000000000000001
100000N00001000000000000000001
111111111111111000001111111111
110000000000000000000000000001
100000000000000000000000000001
111111111111111111111111111111