NO ./textures/wall.xpm
SO ./textures/floor.xpm
WE ./textures/coin.xpm
EA ./textures/door.xpm

F 220,100,0
C 225,0,0

1111111111111111
1000000000000001
1000001111110001
1000000000000001
1000000000000001
100S000000000001
1000000000000001
1001111100000111
1000000000000001
1100000000000001
1100000000000001
1100000000000001
1000000000000001
1000000000000001
1111111111111111