NO ./textures/wall.xpm
SO ./textures/floor.xpm
WE ./textures/coin.xpm
EA ./textures/door.xpm

F 220,100,0
C 225,0,0

111111111111111111111111111111
100000000000000000000000000001
100000000000000000110000000001
100000000000000000000011100001
100000000000000000000000100001
100000000000000000000000100001
100000000000000000000000111111
10000000000100000001000001  11
110000000010100000000000001101
100000000001000000000000000001
111111111111111000001111111111
110000000000000000000000000001
10000000000000000E000000000001
111111111111111111111111111111