
C 50,50,50


NO ./tex/512_wall.xpm
SO ./tex/512_wall.xpm
WE ./tex/512_wall.xpm
EA ./tex/512_wall.xpm
F 0,200,200

                    111111111111111111111111111111
                    100000000000000000000000000001      
                    100000000000000000000000000001      
                    100000000000000000000000000001      
                    100000000000000000000000000001
                    100000000000000001000000000001
                    100000000000000010100000000001
                    110000000000000001000000000001
                     10000000000000000000000000001
                    1111111111D1111111111111111111
                             101
                             101
                             101
                             101
                             101
                             101
                             101
                             101
                             101
                    1111111111D1111111111111111111
                      10000000000000000000000000001
                       10000000E00000000000000000001
                        10000000000000000000000000001
                         10000000000000100000000000001
                          10000000000010100000000000001    
                           10000000000010000000000000001   
                            10000000000000000000000000001  
                             10000000000000000000000000001
                            10000000000000000000000000001
                           10000000000000000000000000001
                          10000000000000000000000000001
                          10000000000000000000000000001
                          10000000000000000000000000001
                          10000000000000000000000000001
                          10000000000000000000000000001
                          10000000000000000000000000001
                          10000000000000000000000000001
                          10000000000000000000000000001
                          10000000000000000000000000001
                          10000000000000000000000000001
                          10000000000000000000000000001
                          10000000000000000000000000001
                          10000000000000000000000000001
                          10000000000000000000000000001
                          10000000000000000000000000001
                          10000000000000000000000000001
                          10000000000000000000000000001
                          10000000000000000000000000001
                          10000000000000000000000000001
                          10000000000000000000000000001
                          10000000000000000000000000001
                          10000000000000000000000000001
                          10000000000000000000000000001
                          10000000000000000000000000001
                          10000000000000000000000000001
                          10000000000000000000000000001
                          10000000000000000000000000001
                          10000000000000000000000000001
                          10000000000000000000000000001
                          10000000000000000000000000001
                          10000000000000000000000000001
                          10000000000000000000000000001
                          10000000000000000000000000001
                          10000000000000000000000000001
                          10000000000000000000000000001
                          10000000000000000000000000001
                          10000000000000000000000000001
                          10000000000000000000000000001
                          10000000000000000000000000001
                          10000000000000000000000000001
                          10000000000000000000000000001
                          10000000000000000000000000001
                          10000000000000000000000000001
                          10000000000000000000000000001
                          10000000000000000000000000001
                          10000000000000000000000000001
                          10000000000000000000000000001
                          10000000000000000000000000001
                          10000000000000000000000000001
                          10000000000000000000000000001
                          10000000000000000000000000001
                          10000000000000000000000000001
                          10000000000000000000000000001
                          10000000000000000000000000001
                          10000000000000000000000000001
                          10000000000000000000000000001
                          10000000000000000000000000001
                          10000000000000000000000000001
                          10000000000000000000000000001
                          10000000000000000000000000001
                          10000000000000000000000000001
                          10000000000000000000000000001
                          10000000000000000000000000001
                          10000000000000000000000000001
                          10000000000000000000000000001
                          10000000000000000000000000001
                          10000000000000000000000000001
                          10000000000000000000000000001
                          10000000000000000000000000001
                          10000000000000000000000000001
                          10000000000000000000000000001
                          10000000000000000000000000001
                          10000000000000000000000000001
                          10000000000000000000000000001
                          10000000000000000000000000001
                          10000000000000000000000000001
                          10000000000000000000000000001
                          10000000000000000000000000001
                          10000000000000000000000000001
                          10000000000000000000000000001
                          10000000000000000000000000001
                          10000000000000000000000000001
                          10000000000000000000000000001
                          10000000000000000000000000001
                          10000000000000000000000000001
                          10000000000000000000000000001
                          10000000000000000000000000001
                          10000000000000000000000000001
                          10000000000000000000000000001
                          10000000000000000000000000001
                          10000000000000000000000000001
                          10000000000000000000000000001
                          10000000000000000000000000001
                          10000000000000000000000000001
                          10000000000000000000000000001
                          10000000000000000000000000001
                          10000000000000000000000000001
                          10000000000000000000000000001
                          10000000000000000000000000001
                          10000000000000000000000000001
                          10000000000000000000000000001
                          10000000000000000000000000001
                          10000000000000000000000000001
                          10000000000000000000000000001
                          10000000000000000000000000001
                          10000000000000000000000000001
                          10000000000000000000000000001
                          10000000000000000000000000001
                          10000000000000000000000000001
                          10000000000000000000000000001
                          10000000000000000000000000001
                          10000000000000000000000000001
                          10000000000000000000000000001
                          10000000000000000000000000001
                          10000000000000000000000000001
                          10000000000000000000000000001
                          10000000000000000000000000001
                          10000000000000000000000000001
                          10000000000000000000000000001
                          10000000000000000000000000001
                          10000000000000000000000000001
                          10000000000000000000000000001
                          10000000000000000000000000001
                          10000000000000000000000000001
                          10000000000000000000000000001
                          10000000000000000000000000001
                          10000000000000000000000000001
                          10000000000000000000000000001
                          10000000000000000000000000001
                          10000000000000000000000000001
                          10000000000000000000000000001
                          10000000000000000000000000001
                          10000000000000000000000000001
                          11111111111111111111111111111