NO ./textures/wall.xpm
SO ./textures/floor.xpm
WE ./textures/coin.xpm
EA ./textures/door.xpm

F 50,50,50
C 0,200,200

11111111
1E000001 
10101001 
11111111