NO ./tex/512_wall.xpm
SO ./tex/512_wall.xpm
WE ./tex/512_wall.xpm
EA ./tex/512_wall.xpm

C     50,   50,    50
F      0,    200,    200

1111111111111111
1000000000000001
1000001110110001
1000000001000001
1000000000000001
1000001000000001
1000000010000001
1000001101000111
10000000N0000001
1111111111111111