NO ./tex/nowall.xpm
SO ./tex/sowall.xpm
WE ./tex/wewall.xpm
EA ./tex/eawall.xpm

F     50,   50,    50
C      0,    200,    200

1111111111111111
1000000000000001
1000001110110001
1000000001000001
1000000000000001
1000001000000001
1000000010000001
1000001101000111
10000000E0000001
1111111111111111