NO          ./tex/512_nowall.xpm





SO        ./tex/512_sowall.xpm
WE      ./tex/512_wewall.xpm
EA    ./tex/512_eawall.xpm

F  50    ,  50   ,  50     
C 0   ,   200  ,  200  

1111111111111111
1000000001000001
1000001000000001
1000000001000001
 1000000000000001
  11111111D1111111
   1000000000100001
    1000000001000001
     10000000D0000011
      1000000100000001
       100000111111D111
        1000000000000001
1111111111000000000000001
100000000000000111111111
1000000000000001
1000000000000001
1000000000000001
1000000000000001
1000000000000001
1000000000000001
1000000000000001
1000000010000001
1000001101000111
10000000E0000001
1111111111111111