NO ./textures/wall.xpm
SO ./textures/floor.xpm
WE ./textures/coin.xpm
EA ./textures/door.xpm

F 50,50,50
C 0,200,200

1111111111111111
1000000000000001
1000001110110001
1000000001000001
1000000000000001
1000000000000001
1000000000000001
1000000010000001
1000001101000111
10000000E0000001
1111111111111111